11111111111
1PEC1111111
11111111111